Guêpe : Attaque
Abeille : soins
Faucon pélerin: Attaque illimité
rouge-gorge: Vol 1 carte en main
Laitue: nourri (soins)
Christe-Marine: Stocke les actions
Immortel des dunes: Régénération
Lézard des murailles: Rénénération
Mante religieuse: Attaque
Figuier: soigne
Goéland: attaque
Cormoran: Attaque
Agave d'Amérique : Ajoute Attaque
Asperge sauvage : soins
Pin d'alep: Attaque
Criquet : Attaque
Criquet egyptien : Attaque
Cigale: -1 en Action
Choucas des tours : Vol une carte posée
Évax pygmée: -1 At
Pavot: Supprime une carte
Scaurus des ruines: Attaque  + Immunité au pouvoir
Scorpion à pattes jaunes : Attaque sa mère
Scolopendre ceinturée: + Action
Séneçon cinéraire: Protège une carte
Moineau domestique: regarder des cartes
Tichodrome échelette: Picoher des cartes
Egilope à inflorescence ovale: Soins
Lapin de garenne: Stocke des actions
Moineau domestique: voir une carte
Monticole merle-bleu: voir cartes posée
Phagnalon des rochers:  protège une carte du vol
Laiteron glauque: renvoie les dégâts absorbé
Hélicette ponctuée: absrobe les prochains dégats
Phyllodactyle d'Europe: Vol prochaine carte jouée par adversaire
Punaise: Pioche une carte par pt attaque prochaine attaque
Nerprun:Pioche une carte par attaque subie
Busard des roseaux: Attaque 
Faucon crécerelle: Attaque
Grande ortie: Soins Illimité
